//syntax matters!!!
//double slash == comment

//size: [WIDTH]x[HEIGHT]

size: 48x28

//tiles: [NUMBER OF TILES]
//each tile has format
//[TILE INDEX] - [TILE NAME] - [TILE COLLISION BOOLEAN (true = blocks movement, false = does not)]
//the tile name is the name used for the texture file!!!

tiles: 7
0 - grass - false
1 - rock - true
2 - rock_floor - false
3 - sand - false
4 - wood_floor - false
5 - wood_wall - true
6 - water - true

//spawn:
//X,Y tile coordinate of the spawn point
//this is where the player will be placed upon loading the map

spawn: 10,8

entities: 5
friend - critter - 8 - 1 - 14,8
friend - critter - 8 - 1 - 14,8
friend - critter - 8 - 1 - 14,8
friend - critter - 8 - 1 - 14,8
friend - snail - 8 - 1 - 14,8

//layout:
//WIDTH x HEIGHT grid of integer values
//each integer represents a tile, following the
//tile indices as given above, in the tiles: section
//separate each integer with whitespace
//supports multi-digit integers

layout:
0 0 0 0 0 0 0 0 0 0 0 0 0 0 0 0 0 0 0 0 0 0 0 0 0 0 0 0 0 0 0 0 0 0 0 0 0 0 0 0 0 0 0 0 0 0 0 0
0 0 0 0 0 0 0 0 0 0 0 0 0 0 0 0 0 0 0 0 0 0 0 0 0 0 0 0 0 0 0 0 0 0 0 0 0 0 0 0 0 0 0 0 0 0 0 0
0 0 0 0 0 0 0 0 0 0 0 0 0 0 0 0 0 0 0 0 0 0 0 0 0 0 0 0 0 0 0 0 0 0 0 0 0 0 0 0 0 0 0 0 0 0 0 0
0 0 0 0 0 0 0 0 0 0 0 0 0 0 0 0 0 0 0 0 0 0 0 0 0 0 0 0 0 0 0 0 0 0 0 0 0 0 0 0 0 0 0 0 0 0 0 0
0 0 0 0 0 0 0 0 0 0 0 0 0 0 0 0 0 0 0 0 0 0 0 0 0 0 0 0 0 0 0 0 0 0 0 0 0 0 0 0 0 0 0 0 0 0 0 0
0 0 0 0 0 0 0 0 0 0 0 0 0 0 0 0 0 0 0 0 0 0 0 0 0 0 0 0 0 0 0 0 0 0 0 0 0 0 0 0 0 0 0 0 0 0 0 0
0 0 0 0 0 0 0 0 1 1 1 1 1 1 1 1 1 1 1 1 1 1 1 1 1 1 1 1 1 1 1 1 1 1 1 1 1 1 1 1 0 0 0 0 0 0 0 0
0 0 0 0 0 0 0 0 1 0 0 0 0 0 0 0 0 0 0 0 0 0 3 3 2 2 2 2 2 2 2 1 2 2 2 2 2 2 2 1 0 0 0 0 0 0 0 0
0 0 0 0 0 0 0 0 1 0 3 3 3 3 3 3 3 3 0 0 0 0 0 3 1 2 2 2 2 2 2 2 2 2 2 2 2 2 2 1 0 0 0 0 0 0 0 0
0 0 0 0 0 0 0 0 1 0 0 0 0 0 0 0 0 3 3 0 0 0 0 0 1 2 2 2 2 2 2 1 2 2 2 2 2 2 2 1 0 0 0 0 0 0 0 0
0 0 0 0 0 0 0 0 1 0 3 3 3 3 0 0 0 0 3 0 0 1 0 0 1 1 1 1 1 1 1 1 2 2 2 2 2 2 2 1 0 0 0 0 0 0 0 0
0 0 0 0 0 0 0 0 1 0 3 6 6 3 0 0 0 0 3 0 0 0 0 0 1 2 2 2 2 2 2 2 2 2 2 1 2 2 2 1 0 0 0 0 0 0 0 0
0 0 0 0 0 0 0 0 1 0 3 3 3 3 0 0 0 0 3 0 0 0 0 0 1 2 2 2 2 2 2 2 2 2 2 2 2 2 2 1 0 0 0 0 0 0 0 0
0 0 0 0 0 0 0 0 1 0 5 5 5 5 5 5 5 0 3 0 1 1 1 1 1 1 2 2 1 1 1 1 1 1 1 1 1 1 1 1 0 0 0 0 0 0 0 0
0 0 0 0 0 0 0 0 1 0 5 4 4 4 4 4 5 0 3 0 0 0 0 0 0 3 3 3 3 0 0 0 0 0 0 0 0 0 0 1 0 0 0 0 0 0 0 0
0 0 0 0 0 0 0 0 1 0 5 4 4 4 4 4 5 0 3 0 0 0 0 0 0 0 0 0 0 0 0 0 0 0 0 0 0 0 0 1 0 0 0 0 0 0 0 0
0 0 0 0 0 0 0 0 1 0 5 4 4 4 4 4 4 0 3 3 0 0 0 0 0 0 0 0 0 3 3 3 3 3 3 0 0 0 0 1 0 0 0 0 0 0 0 0
0 0 0 0 0 0 0 0 1 0 5 4 4 4 4 4 5 0 0 3 3 3 3 3 3 3 3 3 3 3 3 6 6 6 3 3 3 0 0 1 0 0 0 0 0 0 0 0
0 0 0 0 0 0 0 0 1 0 5 4 4 4 4 4 5 0 0 0 0 0 0 0 0 0 0 0 3 3 6 6 6 6 3 3 3 3 0 1 0 0 0 0 0 0 0 0
0 0 0 0 0 0 0 0 1 0 5 5 5 5 5 5 5 0 0 0 1 0 0 0 0 0 0 0 0 3 3 3 3 3 3 1 3 3 3 1 0 0 0 0 0 0 0 0
0 0 0 0 0 0 0 0 1 0 0 0 0 0 0 0 0 0 0 0 0 0 0 0 0 0 0 0 0 0 0 3 3 3 3 3 3 3 3 1 0 0 0 0 0 0 0 0
0 0 0 0 0 0 0 0 1 1 1 1 1 1 1 1 1 1 1 1 1 1 1 1 1 1 1 1 1 1 1 1 1 1 1 1 1 1 1 1 0 0 0 0 0 0 0 0
0 0 0 0 0 0 0 0 0 0 0 0 0 0 0 0 0 0 0 0 0 0 0 0 0 0 0 0 0 0 0 0 0 0 0 0 0 0 0 0 0 0 0 0 0 0 0 0
0 0 0 0 0 0 0 0 0 0 0 0 0 0 0 0 0 0 0 0 0 0 0 0 0 0 0 0 0 0 0 0 0 0 0 0 0 0 0 0 0 0 0 0 0 0 0 0
0 0 0 0 0 0 0 0 0 0 0 0 0 0 0 0 0 0 0 0 0 0 0 0 0 0 0 0 0 0 0 0 0 0 0 0 0 0 0 0 0 0 0 0 0 0 0 0
0 0 0 0 0 0 0 0 0 0 0 0 0 0 0 0 0 0 0 0 0 0 0 0 0 0 0 0 0 0 0 0 0 0 0 0 0 0 0 0 0 0 0 0 0 0 0 0
0 0 0 0 0 0 0 0 0 0 0 0 0 0 0 0 0 0 0 0 0 0 0 0 0 0 0 0 0 0 0 0 0 0 0 0 0 0 0 0 0 0 0 0 0 0 0 0
0 0 0 0 0 0 0 0 0 0 0 0 0 0 0 0 0 0 0 0 0 0 0 0 0 0 0 0 0 0 0 0 0 0 0 0 0 0 0 0 0 0 0 0 0 0 0 0